1111111111111111111
1010001110000010001
1000101110101010101
1101100000001010001
1101101011101010101
1000001000000000101
1011101110111011101
1000100000000000001
1110101010111011111
1010001010001011111
1011111010101011101
1000000010001001101
1011011110101101101
1011000000100000001
1111111111111111111
